@......H..#..#......................
....................................
....................................
....................................
.......&..E..*......................
.....[__________]..+..+..[].........
.....############.........##........
[__]......................##........