#................#
#.H..E...........#
#....#...........#
#...##.#...#....F#
########..###..###