#................#
#.HE.............#
#....#...........#
#...##.#...#....F#
########..###..###