#................#
#.H..............#
#....#...........#
#...##.#...#....E#
########..###..###