@......H..#..#......................
....................................
....................................
...................F................
.......&.....*......................
.....[__________].....+...[]........
.....############.........##........
[__]......................##........