@......HE.#..#......................
....................................
....................................
..................F.................
.......&.....*......................
.....[__________].....+...[]........
.....############.........##........
[__]......................##........