@......H..#..#
..............
..............
.........E....
..............
...F..........
...##.......##
...#.#......##
###########.##
............##
............##=