@.........#
....#......
...#.#.....
###########
...........
...........