@......H..#..#
...##.......##
...#.#......##
###########.##
............##
............##