@......H..#..#
....#.......##
...#.#......##
###########.##
............##
............##