@...F..H..#..#......................
....................................
....................................
.................................F..
.......&.....*......................
.....[__________].....+...[]........
.....############.........##........
[__]......................##........