@...F..H..#..#
....#.......##
...#.#......##
###########.##
............@@
............##