@...F..H..#..#
..............
..............
..............
..............
..............
...##.......##
...#.#......##
###########.##
............##
............##=