@......HE.#..#......................
....................................
....................................
....................................
.......&.....*......................
.....[__________]..+..+...[]..F.....
.....############.........##........
[__]......................##........