@......H...........................
....................................
....................................
....................................
.......&...E.*......................
.....[__________]..+..+...[]..F.....
.....############.........##........
[__]......................##........