#@@@@................
#@@@@................
#@@@@................
#....................
##...................
###..................
####.................
#####................
######...............
#######..............
####.H..EE...........
#######.@@@......F...
###########..[______]