#................#
#.H..............#
#....#...........#
#...##.#...#....F#
########..###..###